-1 -1 -1 -1 -1 -1 -1 -1 -1 -1 -1 -1 -1 -1 -1 -1 -1 -1 -1 -1 -1 -1 -1 -1 -1 -1 3 3 3 3
-1 -1 -1 -1 -1 -1 -1 -1 -1 -1 -1 -1 -1 -1 -1 -1 -1 -1 -1 -1 -1 -1 -1 -1 -1 -1 3 3 3 3
3 -1 -1 -1 -1 -1 -1 -1 -1 -1 -1 -1 -1 -1 -1 -1 -1 -1 -1 -1 -1 -1 -1 -1 -1 3 3 3 3 3
3 -1 -1 -1 -1 -1 -1 -1 -1 -1 -1 -1 -1 -1 -1 -1 -1 -1 -1 -1 -1 -1 -1 -1 -1 3 3 3 3 3
3 -1 -1 -1 -1 -1 -1 -1 -1 -1 -1 -1 -1 -1 -1 -1 -1 -1 -1 -1 -1 -1 -1 -1 -1 3 3 3 3 3
3 -1 -1 -1 -1 -1 -1 -1 -1 -1 -1 -1 -1 -1 -1 -1 -1 -1 -1 -1 -1 -1 -1 -1 -1 3 3 3 3 3
-1 -1 -1 -1 -1 -1 -1 -1 -1 -1 37 38 -1 -1 -1 -1 -1 19 -1 -1 -1 -1 -1 -1 -1 -1 -1 -1 -1 -1
-1 -1 -1 -1 -1 -1 -1 -1 -1 -1 39 40 -1 -1 -1 -1 -1 -1 -1 -1 -1 -1 -1 -1 -1 -1 -1 -1 -1 -1
37 38 -1 41 42 43 -1 41 42 43 -1 -1 -1 -1 16 -1 41 42 43 -1 -1 -1 -1 -1 -1 -1 -1 -1 -1 -1
39 40 -1 44 45 46 -1 44 45 46 -1 -1 -1 -1 -1 -1 44 45 46 -1 -1 -1 -1 -1 -1 -1 -1 -1 -1 -1
-1 -1 -1 -1 47 -1 -1 -1 47 -1 -1 -1 -1 -1 -1 -1 -1 47 -1 -1 -1 -1 -1 -1 -1 -1 -1 -1 -1 -1
-1 -1 26 27 9 11 27 9 32 34 35 35 36 26 27 9 27 9 27 32 -1 -1 5 5 5 5 3 3 3 3
-1 -1 28 29 30 30 29 30 33 -1 -1 -1 -1 2 29 30 29 30 29 33 -1 -1 30 30 30 30 3 3 3 3
-1 -1 28 30 30 30 30 30 33 -1 -1 -1 2 30 30 30 30 30 30 33 -1 -1 30 30 30 30 3 3 3 3
-1 -1 28 30 30 30 30 30 33 -1 -1 -1 28 30 30 30 30 30 30 33 -1 -1 30 30 30 30 3 3 3 3
-1 -1 28 30 30 30 30 30 33 -1 -1 -1 28 30 30 30 30 30 30 33 -1 -1 30 30 30 30 3 3 3 3
-1 -1 28 30 30 30 30 30 33 -1 -1 -1 28 30 30 30 30 30 30 33 -1 -1 30 30 30 30 3 3 3 3
-1 -1 28 30 30 30 30 30 33 -1 -1 -1 28 30 30 30 30 30 30 33 -1 -1 30 30 30 30 3 3 3 3