-1 -1 -1 -1 -1 -1 -1 -1 -1 -1 -1 -1 -1 -1 -1 -1 -1 -1 -1 -1 -1 -1 -1 -1 -1 -1 -1 -1 -1 -1 -1 -1 -1 -1 -1 -1 -1 -1 -1 -1 -1 -1 -1 -1 -1 -1 -1 -1 -1 -1 -1 -1 -1 -1 -1 -1 -1 -1 -1 -1 -1 -1
-1 -1 -1 -1 -1 -1 -1 51 -1 66 -1 -1 -1 -1 -1 -1 -1 -1 -1 -1 -1 -1 -1 -1 -1 -1 -1 -1 66 -1 -1 -1 -1 -1 -1 -1 -1 -1 -1 -1 -1 -1 -1 -1 -1 -1 -1 -1 -1 -1 -1 -1 -1 -1 -1 -1 -1 -1 66 -1 -1 -1
-1 -1 -1 -1 -1 -1 -1 50 54 65 -1 -1 -1 -1 -1 -1 -1 -1 -1 -1 -1 -1 -1 -1 -1 -1 -1 -1 65 -1 53 -1 54 -1 64 -1 -1 -1 -1 -1 -1 -1 -1 -1 -1 -1 -1 -1 -1 -1 -1 -1 -1 -1 52 -1 53 -1 65 -1 -1 -1
-1 -1 -1 -1 -1 -1 -1 48 48 48 -1 -1 -1 -1 -1 -1 -1 -1 -1 -1 -1 -1 60 61 -1 -1 -1 48 48 48 48 48 48 48 48 -1 -1 -1 -1 -1 66 -1 -1 51 -1 -1 -1 -1 -1 -1 -1 -1 -1 -1 48 48 48 48 48 -1 -1 -1
-1 -1 -1 -1 -1 -1 -1 -1 -1 -1 -1 -1 -1 -1 -1 -1 -1 -1 -1 -1 -1 -1 58 59 -1 -1 -1 -1 -1 -1 -1 -1 -1 -1 -1 -1 -1 -1 -1 -1 65 62 64 50 -1 -1 -1 60 61 -1 -1 52 -1 -1 -1 -1 -1 -1 -1 -1 -1 -1
-1 -1 -1 -1 -1 -1 -1 -1 -1 -1 -1 -1 -1 -1 -1 -1 -1 -1 62 63 64 -1 56 -1 -1 -1 -1 -1 -1 -1 -1 -1 -1 -1 -1 -1 -1 -1 -1 -1 48 48 48 48 -1 -1 -1 58 59 -1 -1 48 -1 -1 -1 -1 -1 -1 -1 -1 -1 -1
-1 -1 53 -1 -1 -1 -1 -1 -1 -1 -1 -1 -1 -1 -1 -1 48 48 48 48 48 48 48 48 -1 -1 -1 -1 -1 -1 -1 -1 -1 -1 -1 -1 -1 -1 -1 -1 -1 -1 -1 -1 -1 -1 -1 56 -1 -1 -1 -1 -1 -1 -1 -1 -1 -1 -1 -1 -1 -1
-1 48 48 -1 -1 -1 -1 -1 62 63 63 64 -1 -1 -1 -1 -1 -1 -1 -1 -1 -1 -1 -1 -1 -1 -1 -1 -1 -1 -1 -1 -1 -1 -1 -1 -1 -1 -1 -1 -1 -1 -1 -1 -1 -1 -1 48 -1 -1 -1 -1 -1 -1 -1 -1 -1 -1 -1 -1 -1 -1
-1 -1 -1 -1 -1 -1 -1 -1 48 48 48 48 -1 -1 -1 -1 60 61 -1 -1 -1 -1 -1 60 61 -1 -1 -1 -1 -1 60 61 -1 -1 -1 -1 -1 -1 -1 -1 -1 -1 -1 -1 -1 -1 -1 -1 -1 -1 -1 -1 -1 -1 -1 -1 -1 -1 -1 -1 -1 -1
-1 -1 -1 -1 -1 -1 -1 -1 -1 -1 -1 -1 -1 -1 -1 66 58 59 -1 -1 -1 51 -1 58 59 -1 51 -1 -1 -1 58 59 -1 -1 51 -1 51 -1 -1 -1 -1 -1 -1 -1 -1 -1 -1 -1 -1 -1 -1 -1 66 -1 -1 -1 -1 -1 -1 -1 -1 -1
-1 -1 52 -1 54 -1 -1 -1 -1 -1 -1 -1 -1 -1 -1 65 56 -1 54 53 -1 50 -1 56 -1 -1 50 -1 55 -1 56 53 -1 -1 50 -1 50 -1 -1 -1 -1 -1 -1 -1 62 63 64 -1 -1 -1 -1 -1 65 -1 -1 -1 -1 -1 -1 -1 -1
48 48 48 48 48 48 48 -1 -1 -1 -1 -1 -1 -1 48 48 48 48 48 48 48 48 48 48 -1 -1 48 48 48 48 48 48 48 48 48 48 48 -1 -1 -1 -1 -1 -1 -1 48 48 48 48 48 48 48 48 48 48 48 48 48 48 48 48
49 49 49 49 49 49 49 -1 -1 -1 -1 -1 -1 -1 49 49 49 49 49 49 49 49 49 49 -1 -1 49 49 49 49 49 49 49 49 49 49 49 -1 -1 -1 -1 -1 -1 -1 49 49 49 49 49 49 49 49 49 49 49 49 49 49 49 49
49 49 49 49 49 49 49 -1 -1 -1 -1 -1 -1 -1 49 49 49 49 49 49 49 49 49 49 62 64 49 49 49 49 49 49 49 49 49 49 49 62 63 63 63 63 63 64 49 49 49 49 49 49 49 49 49 49 49 49 49 49 49 49
49 49 49 49 49 49 49 67 68 67 68 67 68 68 49 49 49 49 49 49 49 49 49 49 67 68 49 49 49 49 49 49 49 49 49 49 49 67 68 67 68 67 68 67 49 49 49 49 49 49 49 49 49 49 49 49 49 49 49 49
49 49 49 49 49 49 49 69 69 69 69 69 69 69 49 49 49 49 49 49 49 49 49 49 69 69 49 49 49 49 49 49 49 49 49 49 49 69 69 69 69 69 69 69 49 49 49 49 49 49 49 49 49 49 49 49 49 49 49 49
49 49 49 49 49 49 49 69 69 69 69 69 69 69 49 49 49 49 49 49 49 49 49 49 69 69 49 49 49 49 49 49 49 49 49 49 49 69 69 69 69 69 69 69 49 49 49 49 49 49 49 49 49 49 49 49 49 49 49 49
49 49 49 49 49 49 49 69 69 69 69 69 69 69 49 49 49 49 49 49 49 49 49 49 69 69 49 49 49 49 49 49 49 49 49 49 49 69 69 69 69 69 69 69 49 49 49 49 49 49 49 49 49 49 49 49 49 49 49 49
49 49 49 49 49 49 49 69 69 69 69 69 69 69 49 49 49 49 49 49 49 49 49 49 69 69 49 49 49 49 49 49 49 49 49 49 49 69 69 69 69 69 69 69 49 49 49 49 49 49 49 49 49 49 49 49 49 49 49 49
49 49 49 49 49 49 49 69 69 69 69 69 69 69 49 49 49 49 49 49 49 49 49 49 69 69 49 49 49 49 49 49 49 49 49 49 49 69 69 69 69 69 69 69 49 49 49 49 49 49 49 49 49 49 49 49 49 49 49 49
49 49 49 49 49 49 49 69 69 69 69 69 69 69 49 49 49 49 49 49 49 49 49 49 69 69 49 49 49 49 49 49 49 49 49 49 49 69 69 69 69 69 69 69 49 49 49 49 49 49 49 49 49 49 49 49 49 49 49 49
49 49 49 49 49 49 49 69 69 69 69 69 69 69 49 49 49 49 49 49 49 49 49 49 69 69 49 49 49 49 49 49 49 49 49 49 49 69 69 69 69 69 69 69 49 49 49 49 49 49 49 49 49 49 49 49 49 49 49 49
49 49 49 49 49 49 49 69 69 69 69 69 69 69 49 49 49 49 49 49 49 49 49 49 69 69 49 49 49 49 49 49 49 49 49 49 49 69 69 69 69 69 69 69 49 49 49 49 49 49 49 49 49 49 49 49 49 49 49 49
